AUD;AUD;;0;0;0
COR;COR;;0;0;0
DEB;DEB;;0;0;0
EDI;EDI;;0;0;0
FES;FES;;0;0;0
GMP;GMP;;0;0;0
HID;HID;;0;0;0
LLR;LLR;;0;0;0
OMP;OMP;;0;0;0
OTH;OTH;;0;0;0
PHY;PHY;;0;0;0
PLA;PLA;;0;0;0
RES;RES;;0;0;0
SDK;SDK;;0;0;0
SGC;SGC;;0;0;0
SKA;SKA;;0;0;0
VFX;VFX;;0;0;0