asubsystem,AUD,COR,DEB,EDI,FES,GMP,HID,LLR,OMP,PHY,PLA,RES,SDK,SGC,SKA,VFX
AUD,8,7,3,3,2,3,1,4,1,2,5,5,4,2,3,0
COR,6,9,6,4,5,6,7,9,5,8,7,8,5,6,4,3
DEB,1,6,7,2,2,4,3,4,2,1,2,3,2,1,2,0
EDI,4,6,4,6,6,5,5,6,2,3,5,5,3,3,5,4
FES,3,8,4,3,9,5,6,7,2,3,3,5,2,4,4,1
GMP,4,9,5,5,6,9,4,5,4,7,5,7,3,3,6,3
HID,2,7,2,2,3,3,8,6,1,0,4,2,3,0,0,0
LLR,2,9,4,4,5,5,5,9,2,6,5,8,5,6,5,3
OMP,1,7,3,2,2,2,3,2,7,2,5,3,4,1,2,0
PHY,1,9,4,3,2,5,2,7,1,9,4,6,5,4,4,3
PLA,3,7,3,4,4,5,6,5,3,2,8,4,3,0,2,1
RES,2,8,4,4,4,2,2,5,4,4,5,9,5,2,4,2
SDK,0,4,1,0,2,0,0,2,0,0,1,1,5,0,1,0
SGC,2,7,3,3,3,3,1,5,0,3,2,4,1,7,3,2
SKA,3,8,2,4,3,5,1,8,2,4,4,4,2,6,9,1
VFX,1,6,2,3,1,3,1,6,1,4,4,4,2,4,2,6
